R      1920             1080
NO ./pics/mossy.xpm
SO ./pics/redbrick.xpm
WE ./pics/wood.xpm
EA ./pics/greystone.xpm
S ./pics/barrel.xpm

F                            255,        255,    0
C   0 ,                  0 ,     0

111111111
102010201
102220E01
111111111