R      1920             1080
NO ./pics/mossy.xpm
SO ./pics/redbrick.xpm
WE ./pics/wood.xpm
EA ./pics/greystone.xpm
S ./pics/barrel.xpm

F     220,        100,    0
C   225 ,                  30 ,     0

111111111
100010001
1000S0001
111111111